NO ./textures/blue.xpm
SO    ./textures/grey.xpm
WE  ./textures/red.xpm
EA  ./textures/purple.xpm

F      245,120,66





C         66,197,245


    1111111111111111111111111
    1111111111111111111111111
    100000000011000000000001
    101100000111000000000001
    100100000000000000000011
    111111111011000001110000000000001
    10000000011000001110111111111111
    11110111111111011100000010001
    11110111111111011101010010001
    11000000110101011100000010001
    10000W000000000110000010001
    1000000000000001101010010001
    1100000111010101111101111000111
    11110111 1110101 101111010001
    11111111 1111111 111111111111